FTFFFFFF
FTTTTFTF
FFTFTFTF
FFFFTFTT
FTTTTFTF
FTFFFFTF
FTTTTTTF
FFFFFTTF