TFFFFFFFFFFFFFF
TFTTTTTTTTTTTTF
TTTFFTTFFFFFFTF
FFFFFFTTFFFFTTF
FFFFFFFTTFFFTFF
FFFFFFFFTTFFTTF
FTTTFFFFFTTFFTF
FFTFFFFFFFTTFTF
FTTTFFFFFFFTTTF
FFFFFFFFFFFFFFF