FFFFFFFF
FTTTTFTF
FFTFTFTF
FFFFTFTF
FTTTTFTF
FTFFFFTF
FTTTTTTF
FFFFFFFF